╔═══════════════════╗
║                   ║
║                   ║
║                   ║
║                   ║
║                   ║
║                   ║
║                   ║
║                   ║
║                   ║
╚═══════════════════╝