╔═══════════════════╗
║                   ║
║                   ║
║   ═════════════   ║
║                   ║
║                   ║
║                   ║
║   ═════════════   ║
║                   ║
║                   ║
╚═══════════════════╝